##################
#                #
#   >  O   X     #
#      OO        #
#      #         #
#      O#        #
#      #O        #
#                #
#                #
#                #
##################
